<program>:	TK_MAIN	TK_FUNID	
<otherFunctions>:	TK_EPS	TK_FUNID	
<mainFunction>:	TK_MAIN	
<stmts>:	TK_RETURN	TK_TYPE	TK_RECORD	TK_UNION	TK_DEFINETYPE	TK_WHILE	TK_IF	TK_READ	TK_WRITE	TK_ID	TK_SQL	TK_CALL	
<stmt>:	TK_WHILE	TK_IF	TK_READ	TK_WRITE	TK_ID	TK_SQL	TK_CALL	
<function>:	TK_FUNID	
<input_par>:	TK_INPUT	
<output_par>:	TK_OUTPUT	TK_EPS	
<parameter_list>:	TK_INT	TK_REAL	TK_RECORD	TK_UNION	TK_RUID	
<dataType>:	TK_INT	TK_REAL	TK_RECORD	TK_UNION	TK_RUID	
<remaining_list>:	TK_COMMA	TK_EPS	
<primitiveDatatype>:	TK_INT	TK_REAL	
<constructedDatatype>:	TK_RECORD	TK_UNION	TK_RUID	
<typeDefinitions>:	TK_EPS	TK_RECORD	TK_UNION	TK_DEFINETYPE	
<actualOrRedefined>:	TK_RECORD	TK_UNION	TK_DEFINETYPE	
<typeDefinition>:	TK_RECORD	TK_UNION	
<declarations>:	TK_EPS	TK_TYPE	
<declaration>:	TK_TYPE	
<otherStmts>:	TK_EPS	TK_WHILE	TK_IF	TK_READ	TK_WRITE	TK_ID	TK_SQL	TK_CALL	
<returnStmt>:	TK_RETURN	
<definetypestmt>:	TK_DEFINETYPE	
<fieldDefinition>:	TK_TYPE	
<fieldType>:	TK_INT	TK_REAL	TK_RUID	
<fieldDefinitions>:	TK_TYPE	
<moreFields>:	TK_TYPE	TK_EPS	
<global_or_not>:	TK_COLON	TK_EPS	
<assignmentStmt>:	TK_ID	
<iterativeStmt>:	TK_WHILE	
<conditionalStmt>:	TK_IF	
<elsePart>:	TK_ELSE	TK_ENDIF	
<ioStmt>:	TK_READ	TK_WRITE	
<funCallStmt>:	TK_SQL	TK_CALL	
<singleOrRecId>:	TK_ID	
<option_single_constructed>:	TK_EPS	TK_DOT	
<oneExpansion>:	TK_DOT	
<moreExpansions>:	TK_DOT	TK_EPS	
<arithmeticExpression>:	TK_OP	TK_ID	TK_NUM	TK_RNUM	
<expPrime>:	TK_EPS	TK_PLUS	TK_MINUS	
<term>:	TK_OP	TK_ID	TK_NUM	TK_RNUM	
<termPrime>:	TK_EPS	TK_MUL	TK_DIV	
<factor>:	TK_OP	TK_ID	TK_NUM	TK_RNUM	
<highPrecedenceOperators>:	TK_MUL	TK_DIV	
<lowPrecedenceOperators>:	TK_PLUS	TK_MINUS	
<outputParameters>:	TK_SQL	TK_EPS	
<inputParameters>:	TK_SQL	
<idList>:	TK_ID	
<booleanExpression>:	TK_OP	TK_NOT	TK_ID	TK_NUM	TK_RNUM	
<var>:	TK_ID	TK_NUM	TK_RNUM	
<logicalOp>:	TK_AND	TK_OR	
<relationalOp>:	TK_LT	TK_LE	TK_EQ	TK_GT	TK_GE	TK_NE	
<optionalReturn>:	TK_SQL	TK_EPS	
<more_ids>:	TK_COMMA	TK_EPS	
<A>:	TK_RECORD	TK_UNION	
